############
#..........#
#..........#
#..........#
#..........#
#..........#
#######....#
#..........#
#..........######
#...............#
#...............#
#...............#
#...............#
#...............#
#.......S.......#
#...............#
#.......P.......#
#...............#
#...............#
#...............#
#################
