############
#..........#
#..........#
#..........#
#..........#
#..........#
#######....#
#..........#
#.....E....######
#...............#
#..E............#
#...............#
#...............#
#...............#
#.......S.......#
#...............#
#.......P.......#
#...............#
#...............#
#...............#
#################
