############
#..........#
#..........#
#..........#
#..........#
#..........#
#######....#
#..........#
#..........######
#...............#
#...............#
#...............#
#...............#
#...............#
#...............#
#...............#
#...............#
#...............#
#...............#
#...............#
#################
