############
#..........#
#..........#
#..........#
#..........#
#..........#
#######....#
#..........#
#..........#
#..........#
#..........#
############
